Game Tutorial:
This Interactive Fiction game is a mixture of Galatea, and Façade.
The player can go east, west, north, or south only when they are outside Mary and Mike's house. Once in the house they player can ask Mike and Mary questions which follow these formats:

ask X about Y
ask Mike about job
ask Mary about...
etc...

The players can type "hint" at anytime to get a list of commands they can type to ask Mike, or Mary questions.
There are also options such as attack or defend, which the player can use to take Mike, or Mary's side in the argument.
Based on the player's choices the game will have multiple endings.

A Day in the Life of Mary and Mike
An Interactive Fiction by Amir Ashkan Nourkhalaj
Release 1 / Serial number 150608 / Inform 7 build 6L38 (I6/v6.33 lib 6/12N) SD

Scent of Jasmine mixed with citrus gives you relief. You get to the door. You hear the sound of argument coming from the other side of the door. Standing there, frozen and unsure of what to do.

* * *

Please give one of the answers above.

Would you like to RESTART, RESTORE a saved game, QUIT or UNDO the last command?

Please give one of the answers above.

Would you like to RESTART, RESTORE a saved game, QUIT or UNDO the last command?

* * *

>end1
That's not a verb I recognise.

* * *

>hint
knock, listen, look, s, n

>s
    *** Listening to Mike and Mary argue brings back old memories. It was always hard for you to stay out of their arguments. You alway wanted to jump in and make things better, but somehow things alwats end up getting worse. Mike and Mary didn't like it when you got involved. These are memories you have been trying to forget, so you decide to return home. ***

Would you like to RESTART, RESTORE a saved game, QUIT or UNDO the last command?

>undo
Porch
[Previous turn undone.]

>listen
To get a grasp of the situation, you close your ear to the door and listen carefully.
Woman: "you know what Michael?! I think it's enough. I don't want to talk about it anymore and I'm tired of acting like a fool. That's it for us."
The footsteps of the woman started rushing away from the living room.

>knock
The argument stops and no more sound is coming from the house. As if no one has ever lived in this house. you better knock again.

>knock
You hear someone approaching the door. Then a slightly irritated sound asks from behind the door: "WHO IS IT?" 
You answer: "Your only adorable blind friend!"
You hear the sound of door being opened and smiling voice welcoming you in. 

You get inside the house.

>hint
Ask Mike about: house, day, weather, wife, mary, work, city, argument.

>attack mike
You can't do that action at the moment!

>ask mike about the argumetn
Mike: "It's non of your goddamn business"

>ask mike about the argument
Mike: "Oh! So, we were that loud. It's nothing serious… The usual hiccups in any relationships." 
You hear footsteps entering the room. Mary starts speaking. 
Mary: "What do you mean it's not serious Michael?! How could it get any more serious?" 
You: "It sure is more than a hiccup body" 
Mary: "Why don't you tell him what have you done? Let he be the judge..." 
You: "Nice, I get to be the marriage consultant!" 
You can sense the weight of Mary's look on you. 
Mary: "Can you stop being a wise ass for a second!" 
You: "sorry!"

>hint
Ask Mike about: house, day, weather, wife, mary, work, city, argument, what happened.
Ask Mary about: what happened.

>attack mike
You can't do that action at the moment!

>ask mike about what happened
Mike: "Nothing! Really! I don't know what caused her to act like this. She kept asking me whether I have anything to say to her or not. I'm as confused as you."
Mary starts talking.
Mary: "It started couple of months ago. Mike was coming home late once a week. After a while I realized there is a pattern to it. Every Thursday he would be couple of hours late. Also, every other weekends, he would make up an excuse and would go out for half a day. What's worst is, on Thursdays he always smells of one particular perfume. It never changes. On weekends, the perfumes are mix and hard to distinguish." 
Mike: "Why were you smelling my clothes?!"

>attack mike
"I was prepared to defend you no matter what she throwed at me. But, I don't really know what to say to this Mike. Care to give us some explanations?" 
Mike: "Mary, I'm telling you it's not what you think. I don't even know where did you get these weird ideas. I don't want to hear it anymore." 
Mike stands up. The living room is painfully silence. Mary is holding her tears. 
She looks at you and says: "let me show you something."

Mary leaves her chair and walks to her room. Then immediately comes back while carrying something with herself. She puts the package in front of you.

>undo
House
[Previous turn undone.]

>undo
House
[Previous turn undone.]

>ask mary about what happened
you ask Mary what's wrong. 
Mary: "It started couple of months ago. Mike was coming home late once a week. after a while I realized there is a pattern to it. Every Thursday he would be couple of hours late. Also, every other weekends, he would make up an excuse and would go out for half a day. What's worst is, on Thursdays he always smells of one particular perfume. It never changes. On weekends, the perfumes are mix and hard to distinguish." 
Mike: "Why were you smelling my clothes?!"

>attack mary
"I'm not sure what the result of our talk will be Mary. But, don't you think sniffing Mike's clothes was going a step too far?!" 
Mary: "of course you would side with him. You are his college friend after all."

Mary leaves her chair and walks to her room. Then immediately comes back while carrying something with herself. She puts the package in front of you.

>undo
House
[Previous turn undone.]

>hint
Ask Mike about: house, day, weather, wife, mary, work, city, argument, what happened.
Ask Mary about: what happened.

>ask mary about what happened
you ask Mary what's wrong. 
Mary: "It started couple of months ago. Mike was coming home late once a week. after a while I realized there is a pattern to it. Every Thursday he would be couple of hours late. Also, every other weekends, he would make up an excuse and would go out for half a day. What's worst is, on Thursdays he always smells of one particular perfume. It never changes. On weekends, the perfumes are mix and hard to distinguish." 
Mike: "Why were you smelling my clothes?!"

>hint
You attack or defend either Mike or Mary.
Ask Mike about: house, day, weather, wife, mary, work, city, argument, what happened.
Ask Mary about: what happened.

* * *

>hint
knock, listen, look, s, n

>listen
To get a grasp of the situation, you close your ear to the door and listen carefully.
Woman: "you know what Michael?! I think it's enough. I don't want to talk about it anymore and I'm tired of acting like a fool. That's it for us."
The footsteps of the woman started rushing away from the living room.

>n
(first opening the wooden door)
I think it'd be rude to open someone else's door.

>open door
I think it'd be rude to open someone else's door.

>knock
The argument stops and no more sound is coming from the house. As if no one has ever lived in this house. you better knock again.

>hint
knock, listen, look, s, n

>listen
You can only hear the sound of cars in the street.

>look
Scent of Jasmine mixed with citrus gives you relief. You get to the door. You hear the sound of argument coming from the other side of the door. Standing there, frozen and unsure of what to do.

>knock
You hear someone approaching the door. Then a slightly irritated sound asks from behind the door: "WHO IS IT?" 
You answer: "Your only adorable blind friend!"
You hear the sound of door being opened and smiling voice welcoming you in. 

You get inside the house.

* * *

>hint
Ask Mike about: house, day, weather, wife, mary, work, city, argument.

>s
(first opening the wooden door)
It'd be rude to leave the house now.

>ask mike about 3
4

>attack mike
You can't do that action at the moment!

>attack mary
You can't see any such thing.

>ask about the argument
You can't see any such thing.

>ask mike about the argument
Mike: "Oh! So, we were that loud. It's nothing serious… The usual hiccups in any relationships." 
You hear footsteps entering the room. Mary starts speaking. 
Mary: "What do you mean it's not serious Michael?! How could it get any more serious?" 
You: "It sure is more than a hiccup body" 
Mary: "Why don't you tell him what have you done? Let he be the judge..." 
You: "Nice, I get to be the marriage consultant!" 
You can sense the weight of Mary's look on you. 
Mary: "Can you stop being a wise ass for a second!" 
You: "sorry!"

>attack mike
You can't do that action at the moment!

>hint
Ask Mike about: house, day, weather, wife, mary, work, city, argument, what happened.
Ask Mary about: what happened.

* * *

>ask mary about what happened
you ask Mary what's wrong. 
Mary: "It started couple of months ago. Mike was coming home late once a week. after a while I realized there is a pattern to it. Every Thursday he would be couple of hours late. Also, every other weekends, he would make up an excuse and would go out for half a day. What's worst is, on Thursdays he always smells of one particular perfume. It never changes. On weekends, the perfumes are mix and hard to distinguish." 
Mike: "Why were you smelling my clothes?!"

>hint
You attack or defend either Mike or Mary.

>ask mike about house
It's too serious to ask about something.

>undo
House
[Previous turn undone.]

>ask mike about what happened
It's too serious to ask about something.

>showme
House - room
    Mary - person
    wooden door - locked door
    yourself - person
    Mike - person

>hint
You attack or defend either Mike or Mary.

>attack mike
"I was prepared to defend you no matter what she throwed at me. But, I don't really know what to say to this Mike. Care to give us some explanations?" 
Mike: "Mary, I'm telling you it's not what you think. I don't even know where did you get these weird ideas. I don't want to hear it anymore." 
Mike stands up. The living room is painfully silence. Mary is holding her tears. 
She looks at you and says: "let me show you something."

Mary leaves her chair and walks to her room. Then immediately comes back while carrying something with herself. She puts the package in front of you.

* * *

>hint
knock, listen, look, s, n

>knock
The argument stops and no more sound is coming from the house. As if no one has ever lived in this house. you better knock again.

* * *

>hint
Ask Mike about: house, day, weather, wife, mary, work, city, argument.

>ask mike about the argument
Mike: "Oh! So, we were that loud. It's nothing serious… The usual hiccups in any relationships." 
You hear footsteps entering the room. Mary starts speaking. 
Mary: "What do you mean it's not serious Michael?! How could it get any more serious?" 
You: "It sure is more than a hiccup body" 
Mary: "Why don't you tell him what have you done? Let he be the judge..." 
You: "Nice, I get to be the marriage consultant!" 
You can sense the weight of Mary's look on you. 
Mary: "Can you stop being a wise ass for a second!" 
You: "sorry!"

* * *

>hint
Ask Mike about: house, day, weather, wife, mary, work, city, argument, what happened.
Ask Mary about: what happened.

>ask mike what happened
I didn't understand that sentence.

>ask mike abotu what happened
I didn't understand that sentence.

>ask mike abotut what happened
I didn't understand that sentence.

>ask mike about what happened
Mike: "Nothing! Really! I don't know what caused her to act like this. She kept asking me whether I have anything to say to her or not. I'm as confused as you."
Mary starts talking.
Mary: "It started couple of months ago. Mike was coming home late once a week. After a while I realized there is a pattern to it. Every Thursday he would be couple of hours late. Also, every other weekends, he would make up an excuse and would go out for half a day. What's worst is, on Thursdays he always smells of one particular perfume. It never changes. On weekends, the perfumes are mix and hard to distinguish." 
Mike: "Why were you smelling my clothes?!"

>hint
Ask Mike about: house, day, weather, wife, mary, work, city, argument, what happened.
Ask Mary about: what happened.

>attack mike
"I was prepared to defend you no matter what she throwed at me. But, I don't really know what to say to this Mike. Care to give us some explanations?" 
Mike: "Mary, I'm telling you it's not what you think. I don't even know where did you get these weird ideas. I don't want to hear it anymore." 
Mike stands up. The living room is painfully silence. Mary is holding her tears. 
She looks at you and says: "let me show you something."

Mary leaves her chair and walks to her room. Then immediately comes back while carrying something with herself. She puts the package in front of you.

>hint
Ask Mike about: house, day, weather, wife, mary, work, city, argument, what happened.
Ask Mary about: what happened, package.

* * *

>hint
Ask Mike about: house, day, weather, wife, mary, work, city, argument.

>ask mike about the houes
2

>ask mike about the house
You ask Mike about the house. 
Mike: "Ah, it's your first time here. It's not bad. Mary loves the garden. She spends most of her free time there. The house itself is pretty small, the kitchen is cozy and the living room is only a fancified corridor. No complains for the bedroom though. It's big enough for a us to live in it happily." 
You sense a hint of irony in Mike's voice.

>ask mike about house
Mike: "We've already talked about it.

>ask mike about argument
Mike: "Oh! So, we were that loud. It's nothing serious… The usual hiccups in any relationships." 
You hear footsteps entering the room. Mary starts speaking. 
Mary: "What do you mean it's not serious Michael?! How could it get any more serious?" 
You: "It sure is more than a hiccup body" 
Mary: "Why don't you tell him what have you done? Let he be the judge..." 
You: "Nice, I get to be the marriage consultant!" 
You can sense the weight of Mary's look on you. 
Mary: "Can you stop being a wise ass for a second!" 
You: "sorry!"

>hint
Ask Mike about: house, day, weather, wife, mary, work, city, argument, what happened.
Ask Mary about: what happened.

>ask mike about what happened
Mike: "Nothing! Really! I don't know what caused her to act like this. She kept asking me whether I have anything to say to her or not. I'm as confused as you."
Mary starts talking.
Mary: "It started couple of months ago. Mike was coming home late once a week. After a while I realized there is a pattern to it. Every Thursday he would be couple of hours late. Also, every other weekends, he would make up an excuse and would go out for half a day. What's worst is, on Thursdays he always smells of one particular perfume. It never changes. On weekends, the perfumes are mix and hard to distinguish." 
Mike: "Why were you smelling my clothes?!"

>hint
You attack or defend either Mike or Mary.

* * *

>attack mike
"I was prepared to defend you no matter what she throwed at me. But, I don't really know what to say to this Mike. Care to give us some explanations?" 
Mike: "Mary, I'm telling you it's not what you think. I don't even know where did you get these weird ideas. I don't want to hear it anymore." 
Mike stands up. The living room is painfully silence. Mary is holding her tears. 
She looks at you and says: "let me show you something."

Mary leaves her chair and walks to her room. Then immediately comes back while carrying something with herself. She puts the package in front of you.

>hint
Ask Mary about: package.

>ask mary about the package
Mary: "Open it. You'll see."

>open the package
You open package, revealing papers.

>take papers
You open the package and take out the papers inside it.

Taken.

>x papers
There are multiple glossy papers as big as your palm.

>hint
Ask Mary about: package, papers.

>ask mary about the papers
Mary, what are these papers? 
Mary: "Sorry, I forgot about your condition. These are pictures of Mike being intimate with different ladies."

>hint
You attack or defend either Mike or Mary.

>attack mike
 knowWhy is 3

>hint
You attack or defend either Mike or Mary.

>attack mike
knowWhy is 4

>attack mike
 knowWhy is 5

>ask mike about what happened
Mike "C'mon Not Now"

>ask mary about the package
Mary: "What else do you wanna know?"

>ask mary about asdl;ashdf;
Mary: "Not Now."

* * *

>story
That's not a verb I recognise.

>x story
You can't see any such thing.

* * *

>knock
The argument stops and no more sound is coming from the house. As if no one has ever lived in this house. you better knock again.

>ring the bell
You hear someone approaching the door. Then a slightly irritated sound asks from behind the door: "WHO IS IT?" 
You: "Your only adorable blind friend!"
You hear the sound of door being opened and smiling voice welcoming you in. 

You get inside the house.

>ask mike about the argument
You: "Is everything ok between you guys?"
Mike: "Oh! So, we were that loud? It's nothing serious… The usual hiccups in any relationships."
You hear footsteps entering the room. Mary starts speaking.
Mary: "What do you mean it's not serious Michael?! How could it get any more serious?"
You: "It sure sounds more than a hiccup body" 
Mary: "Why don't you tell your friend what you've done and let he be the judge..." 
You: "Nice, I get to be the marriage counselor!" 
You can sense the weight of Mary's look on you. 
Mary: "Can you stop being a wise ass for a second!" 
You: "sorry!"

* * *

>knock
The argument stops and no more sound is coming from the house. As if no one has ever lived in this house. you better knock again.

>knock
You hear someone approaching the door. Then a slightly irritated sound asks from behind the door: "WHO IS IT?" 
You: "Your only adorable blind friend!"
You hear the sound of door being opened and smiling voice welcoming you in. 

You get inside the house.

>ask mike about the argument
You: "Is everything ok between you guys?"
Mike: "Oh! So, we were that loud? It's nothing serious… The usual hiccups in any relationships."
You hear footsteps entering the room. Mary starts speaking.
Mary: "What do you mean it's not serious Michael?! How could it get any more serious?"
You: "It sure sounds more than a hiccup body" 
Mary: "Why don't you tell your friend what you've done and let he be the judge..." 
You: "Nice, I get to be the marriage counselor!" 
You can sense the weight of Mary's look on you. 
Mary: "Can you stop being a wise ass for a second!" 
You: "sorry!"

>ask mike about what happened
You: "What happened?"
Mike: "Nothing! Really! I don't know what caused her to act like this. She kept asking me whether I have anything to say to her or not. I'm as confused as you."
Mary: "It started couple of months ago. Mike was coming home late once a week. After a while I realized there is a pattern to it. Every Thursday he would be couple of hours late. Also, every other weekends, he would make up an excuse and would go out for half a day. What's worst is, on Thursdays he always smells of one particular perfume. It never changes. On weekends, the perfumes are mix and hard to distinguish."
Mike: "Why were you smelling my clothes?!"

>attack mike
You: "I was prepared to defend you no matter what she threw at me. But, I don't really know what to say to this Mike. Care to give us some explanations?" 
Mike: "Mary, I'm telling you it's not what you think. I don't even know where you got these weird ideas. I don't want to hear it anymore." 
Mike stands up. The living room is painfully silent. Mary is holding her tears. She looks at you.
Mary: "let me show you something."

Mary leaves her chair and walks to her room. Then immediately comes back while carrying something with herself. She puts a package in front of you.

>take package
Taken.

>open package
You open package, revealing papers.

>take papers
You open the package and take out the papers inside it.

Taken.

* * *

>x papers
There are multiple glossy papers as big as your palm.

I beg your pardon?

>ask mary about the papers
You: "Mary, what are these papers?"
Mary: "Sorry, I forgot about your condition. These are pictures of Mike being intimate with different ladies."

>attack mike
You: "Mike, what are these?"
Mike: "These "intimate" photos consist of me dancing with some other ladies. Why would you have these photos Mary?! Were you spying on me?"
Mary: ""LADIES"?! They are whores! And to answer your question Mike, YES. I hired someone to follow you."

>undo
House
[Previous turn undone.]

>attack mary
You: "Mary, what are these photos exactly? How did you get a hold of these photos? I'm gonna go out on a limb and say Mike didn't provide them. At least not volunteeringly."
Mary: "They are pictures of him dancing with other women."
Mike: "What have you done Mary?"
Mary: "What have "I" done?! Really?! Is this all you can say after everything that's happened? What HAVE I DONE?! I consulted with a private investigator and he accepted my case. These are the photos that he's been taking since few months ago."
You: "A private investigator?! Mary I think you've seen too many TV dramas."

>undo
House
[Previous turn undone.]

>defend mike
You: "Mary, can you describe exactly what's in these pictures?"
Mary: "They are picture of Mike dancing with other women."
Mike: "So, what? What are you trying to say Mary?! And while we're at it, care to explain where you got these from?"
Mary: "You know damn well what I'm trying to say Mike. The photos are from a friend of mine who promised me to uncover the truth behind whatever you are hiding."
You: "To uncover the truth…? Mary, don't you think you are overreacting a bit?"
Mary: "Sometimes you have to go the extra mile to protect what is dear to you."

>undo
House
[Previous turn undone.]

>defend mary
You: "Mike, can you explain the content of these photos?"
Mike: "These photos show me dancing with other people. I don't know why Mary is getting so worked up about these. Also, I'm curious to know how she got these?"
Mary: "Can you stop treating me like a fool Mike? And for God's sake stop acting so matter-of-factly about it. It's hurting me seeing how indifferent you've become. The photos are coming from a reliable source. An investigator who was hired by me when I first noticed your abnormal behavior."

>attack mike
You: "First perfumes and now these photos. In my eyes, you were always the faithful type Mike. I wouldn't believe such a thing even I would have seen it with my own two eyes. Why?"
Mary: "Yes Mike, I'd like to know WHY too."
Mike: "I'm not appreciating how you guys are treating me right now. As if I'm a convicted criminal."
Mary: "If we are treating you that way, is because you are acting like one Mike. What is the reason behind all these secretive behaviors?"
Mike: "Fine, jeez. Let me explain then. Yes, I am in those photos and I've been dancing with other ladies. But it's all because I've been taking a dance classes."

>undo
House
[Previous turn undone.]

>attack mary
You: "Mary, you went through all the trouble of hiring an investigator. Have you ever considered asking Mike directly? Aren't you guys husband and wife? Don't you think talking with Mike would have given you the answer that you were looking for faster than any detective in the world?"
Mary: "I… I don't know."
Mike: "OK. This is clearly getting waaay out of hand. Let me explain what's going on"
Mary holds her breath.
Mike: "The pictures are true. But that is literally all there is to it."
Mary: "What do you mean?"
Mike: "Hmmm… How should I put it… Couple of months ago, I made a decision. I've enrolled in a ballroom dancing class."

>undo
House
[Previous turn undone.]

>defend mike
You: "Mary, instead of having someone spy on Mike, shouldn't you have talked to him first? Doesn't he have the right to know before anyone else?"
Mary: "Well I do have the right to know before anyone else too. If for any reason, Mike is bored of our relationship, shouldn't I be the first one that he talks to?"
Mike: "Wow, what's going on here! Can you guys stop talking like I'm not here? And Mary, you do have a vivid and scary imaginations. Didn't that friend of yours, Mr. detective, mention anything else other than the photos?"
Mary: "No, he only sent me the photos and ask me whether I want him to continue the investigation or not. He didn't find any other evidence of anything else.
Mike: "Well because there is nothing to be found Mary! Let me confess what has been going on. I've been taking dance classes."

>undo
House
[Previous turn undone.]

>defend mary
You: "Mike, she has every right to be concern.""
Mike: "But to go as far as hiring someone to follow me? Why couldn't she asked me directly?"
Mary: "I'm sorry… But… But I was afraid."
Mike: "AFRAID?! Of me?""
Mary: "No, Mike. Not of you. Of what I might have heard… Or worse, what you might not have told me.""
Mike: "I'm sorry Mary."

>attack mike
You: "But why so secretive Mike? What are you? An obscurantist?"
Mike: "No, I wasn't trying to hide it… I mean I was, but for good reasons."
Mary: "For what good reasons?"
Mike: "To surprise you… On our anniversary. I've been taking dance classes and practicing with a group on weekends. The daisy fragrance that you smelled on my clothes is my instructor's perfume."
Mary: "I'm sorry Mike. I didn't know."
Mike: "It's alright. At least now I can practice my dance moves with you too."

>undo
House
[Previous turn undone.]

>attack mary
You: "Well, Mary, how do you feel now that you find out you hired a detective only to discover your unfaithful husband was secretly taking dance classes without letting you know?!"
Mary: "Dance classes?! Really? That's all there is to it Mike?"
Mike: "Yes, I told you."
Mary: "But, why didn't you tell me about it?"
Mike: "Because it supposed to be a freaking surprise. On our anniversary."
Mary: "I'm really sorry Mike. I'm feeling really stupid right now."
Mike: "Well you SHOULD Mary. But don't worry too much about it. There is a silverlining to it. As it turned out, I'm a very slow learner and Ms. Arlene, the one who you smelled her daisy perfume, doesn't have any other openings available for private students. I'd appreciate it if you could practice with me. Our anniversary is approaching fast and I invited our parents. There is too much on the line here."
Mary: "Gladly Mike."

>undo
House
[Previous turn undone.]

>defend mike
You: "I knew it. The Mr. Meek Mike and adultery!"
Mike: "You shut up!"
You: "But why hide it?"
Mike: "Well, it was supposed to be a surprise."
You: "Well it sure was."
Mary: "What do you mean, SURPRISE?!"
Mike: "For our anniversary. I've planned a small party. I talked to your dad and he told me that you like Waltz, Tango and Salsa. Every Thursday, I was practicing Waltz and Tango. The perfume that you smelled was from my instructor. Every other weekend, there is a social club gathering in town. I've been participating and practicing Salsa. I don't have a fixed partner and I'm practicing with whoever's available; hence the mixed perfumes."
Mary: "Oh, Mike. I am so sorry. I'm so stupid. What have I been thinking?!"
Mike: "Let me help you Mary. You WEREN'T THINKING at all!"
Mike finished his sentence with a reassuring smile.

>undo
House
[Previous turn undone.]

>defend mary
You: "Well I guess Mary's friend wasn't too far off with those photos. So, Mr. Baryshnikov, why so secret? I don't think Mary would be as bothered by it as she is now if she knew what was going on"
Mike: "Because I didn't want her to find out"
Mary: "Why not Mike?"
Mike: "Because of you Mary. It supposed to be a surprise for you. The picture I had in mind was slightly different than what is happening now. I imagined everyone in a party are talking and having fun. Suddenly, the dance floor becomes empty and The Blue Danube starts. I'll walk toward you, elegantly. Stop in front of you, bowing graciously and offering my right hand. Your face will be a mixture of shock and embarrassment, but you accept my hand and dance with me. Our parents, friends, and Ms. Arlene, the lady who the Thursdays" perfume belongs to, nodding their heads in acknowledgment."
Mary: "Oh, Mike. I'm so sorry for ruining your surprise."
Mike: "It's alright. I'm sure it wouldn't go that smoothly anyways."
Mary: "I'll tell you what, we are going to rehearse the dance many times before that night and I promise to act as surprised and embarrassed as I can."
Mike: "That's so sweet of you"

* * *

>attack mike
You: "I was prepared to defend you no matter what she threw at me. But, I don't really know what to say to this Mike. Care to give us some explanations?" 
Mike: "Mary, I'm telling you it's not what you think. I don't even know where you got these weird ideas. I don't want to hear it anymore." 
Mike stands up. The living room is painfully silent. Mary is holding her tears. She looks at you.
Mary: "let me show you something."

Mary leaves her chair and walks to her room. Then immediately comes back while carrying something with herself. She puts a package in front of you.

>open package
You open package, revealing papers.

>x papers
There are multiple glossy papers as big as your palm.

>ask mary about papers
You: "Mary, what are these papers?"
Mary: "Sorry, I forgot about your condition. These are pictures of Mike being intimate with different ladies."

>attack mary
You: "Mary, what are these photos exactly? How did you get a hold of these photos? I'm gonna go out on a limb and say Mike didn't provide them. At least not volunteeringly."
Mary: "They are pictures of him dancing with other women."
Mike: "What have you done Mary?"
Mary: "What have "I" done?! Really?! Is this all you can say after everything that's happened? What HAVE I DONE?! I consulted with a private investigator and he accepted my case. These are the photos that he's been taking since few months ago."
You: "A private investigator?! Mary I think you've seen too many TV dramas."

>hint
You can attack or defend either Mike or Mary.

>attack mary
You: "Mary, you went through all the trouble of hiring an investigator. Have you ever considered asking Mike directly? Aren't you guys husband and wife? Don't you think talking with Mike would have given you the answer that you were looking for faster than any detective in the world?"
Mary: "I… I don't know."
Mike: "OK. This is clearly getting waaay out of hand. Let me explain what's going on"
Mary holds her breath.
Mike: "The pictures are true. But that is literally all there is to it."
Mary: "What do you mean?"
Mike: "Hmmm… How should I put it… Couple of months ago, I made a decision. I've enrolled in a ballroom dancing class."

* * *

>undo
House
[Previous turn undone.]

>undo
House
[Previous turn undone.]

>[13] attack mary
You can't do that action at the moment!

* * *

>test with ending
I only understood you as far as wanting to test that.

* * *

I beg your pardon?

I beg your pardon?