It was 9A.M. and Tom was awake. He wasn't feeling like usual. Somehow, he was tired even though he had slept pretty well. His schedule was like before, his fiance as lovely as ever, and his boss as tolerable as ever. He didn't know what was wrong with him... He thinks... and thinks... and thinks... Finally! He remembers... His meals, in the last few weeks, were all processed foods. He decided he had enough… It was time to make some changes in his lifestyle. So, he decided, instead of the usual StarBucks breakfast, he will have a smoothie. He dashed out of his bed and went to kitchen.

He took off his phone and looked up the recipe of his favorite smoothie, "Banana Strawberry Milkshake" with a touch of "Cinnamon".

"Preparation time: 7min"

"Calories: 370"

Perfect Breakfast
An Interactive Fiction by Amir Ashkan Nourkhalaj
Release 1 / Serial number 150506 / Inform 7 build 6L38 (I6/v6.33 lib 6/12N) SD

Kitchen
The kitchen is quite large. The roof is covered with lights. The stainless steel appliances are in nice harmony with walnut cabinets. 

You can see a black door, a garbage can (empty), a Refrigerator (in which are Strawberry, Ginger, Banana, Milk and Orange) and a cabinet (in which is cinnamon) here.

>eat banana
That's plainly inedible.

>eat strawberry
(first taking Strawberry)
You eat Strawberry. Not bad.

>x
What do you want to examine?

>x refrigerator
In the Refrigerator are Ginger and Banana.

* * *

>mixing
That's not a verb I recognise.

* * *

>mix strawberry with banana
fucked up

* * *

>go s
(first opening the black door)

Garage
You can see a black door and a shelf (in which are mixer, a scale and a juicer) here.

>x
What do you want to examine?

* * *

>s
(first opening the black door)

Garage
The garage is slightly messy. Then again, what garage isn't. There is a ping pong table dissembled on the ground, a bicycle chained to the wall and a new shining shelf, in harsh contrast with its surrounding inside the garage.  

You can see a black door, a bicycle, a heavy ping pong table and a shelf (in which are Blender (empty), a scale and a juicer) here.

>take black door
That's fixed in place.

>take mixer
Taken.

* * *

>s
(first opening the black door)

Garage
The garage is slightly messy. Then again, what garage isn't. There is a ping pong table dissembled on the ground, a bicycle chained to the wall and a new shining shelf, in harsh contrast with its surrounding inside the garage.  

You can see a black door, a bicycle, a heavy ping pong table and a shelf (in which are Blender (empty), a scale and a juicer) here.

>take blender
Taken.

>n
Kitchen
You can see a black door, a garbage can (empty), a Refrigerator (in which are Strawberry, Ginger, Banana, Milk and Orange) and a cabinet (in which is cinnamon) here.

>drop blender
Dropped.

>put orange into blender
(first taking Orange)
You put Orange into Blender.

>blend
I hope it tastes wonderful

    *** It tastes disgusting. ***

Would you like to RESTART, RESTORE a saved game, QUIT or UNDO the last command?

* * *

>drop blender
Dropped.

>put orange in the blender
(first taking Orange)
You put Orange into Blender.

>blend
I hope it tastes wonderful

    *** It tastes disgusting. ***

Would you like to RESTART, RESTORE a saved game, QUIT or UNDO the last command?

>undo
Kitchen
[Previous turn undone.]

>x blender
In Blender is Orange.

>undo
Kitchen
[Previous turn undone.]

>put ginger in the blender
(first taking Ginger)
You put Ginger into Blender.

>x blender
In Blender are Ginger and Orange.

>blend
I hope it tastes wonderful

    *** It tastes disgusting. ***

Would you like to RESTART, RESTORE a saved game, QUIT or UNDO the last command?

* * *

>drop blender
Dropped.

>put ginger in blender
(first taking Ginger)
You put Ginger into Blender.

>blend
I hope it tastes wonderful

    *** It tastes disgusting. ***

Would you like to RESTART, RESTORE a saved game, QUIT or UNDO the last command?

* * *

>drop blender
Dropped.

>put orange in blender
(first taking Orange)
You put Orange into Blender.

>blend
I hope it tastes wonderful

    *** It tastes disgusting. ***

Would you like to RESTART, RESTORE a saved game, QUIT or UNDO the last command?

* * *

>undo
Kitchen
[Previous turn undone.]

>undo
Kitchen
[Previous turn undone.]

>x blender
Blender is empty.

>put ginger in blender
(first taking Ginger)
You put Ginger into Blender.

>mix
I hope it tastes wonderful

    *** It tastes disgusting. ***

Would you like to RESTART, RESTORE a saved game, QUIT or UNDO the last command?

* * *

>n
Kitchen
You can see a black door, a garbage can (empty), a Refrigerator (in which are Strawberry, Ginger, Banana, Milk and Orange) and a cabinet (in which is cinnamon) here.

>drop oblender
You can't see any such thing.

>drop blender
Dropped.

* * *

>n
Kitchen
You can see a black door, a garbage can (empty), a Refrigerator (in which are Strawberry, Ginger, Banana, Milk and Orange) and a cabinet (in which is cinnamon) here.

>put ginger in blender
(first taking Ginger)
You put Ginger into Blender.

>mix
There is no blender in the kitchen.

>drop blender
Dropped.

>mix
I hope it tastes wonderful

    *** It tastes disgusting. ***

Would you like to RESTART, RESTORE a saved game, QUIT or UNDO the last command?

* * *

>s
(first opening the black door)

Garage
The garage is slightly messy. Then again, what garage isn't. There is a ping pong table dissembled on the ground, a bicycle chained to the wall and a new shining shelf, in harsh contrast with its surrounding inside the garage.  

You can see a black door, a bicycle, a heavy ping pong table and a shelf (in which are Blender (empty), a scale and a juicer) here.

>take juicer
Taken.

>put it into blender
You can't do that.

>take blender
Taken.

>x blender
Blender is empty.

>n
Kitchen
You can see a black door, a garbage can (empty), a Refrigerator (in which are Strawberry, Ginger, Banana, Milk and Orange) and a cabinet (in which is cinnamon) here.

* * *

>drop blender
Dropped.

>put orange into blender
Nice!

>blend
There is nothing in the blender.

>x blender
Blender is empty.

* * *

>s
(first opening the black door)

Garage
The garage is slightly messy. Then again, what garage isn't. There is a ping pong table dissembled on the ground, a bicycle chained to the wall and a new shining shelf, in harsh contrast with its surrounding inside the garage.  

You can see a black door, a bicycle, a heavy ping pong table and a shelf (in which are Blender (empty), a scale and a juicer) here.

>x garage
You can't see any such thing.

>look at
What do you want to look at?

>bicycle
You see nothing special about the bicycle.

>take bicycle
That's fixed in place.

>take ping pong table
You can't see any such thing.

>ping pong
That's not a verb I recognise.

* * *

>s
(first opening the black door)

Garage
The garage is slightly messy. Then again, what garage isn't. There is a ping pong table dissembled on the ground, a bicycle chained to the wall and a new shining shelf, in harsh contrast with its surrounding inside the garage.  

You can see a black door, a bicycle, a heavy ping pong table and a shelf (in which are Blender (empty), a scale and a juicer) here.

>take ping pong table
That's fixed in place.

>take table
That's fixed in place.

* * *

>s
(first opening the black door)

Garage
The garage is slightly messy. Then again, what garage isn't. There is a ping pong table dissembled on the ground, a bicycle chained to the wall and a new shining shelf, in harsh contrast with its surrounding inside the garage.  

You can see a black door, a bicycle, a heavy ping pong table and a shelf (in which are Blender (empty), a scale and a juicer) here.

>test win
(Testing.)

>[1] s
You can't go that way.

>[2] take blender
Taken.

>[3] n

Kitchen
The kitchen is quite large. The roof is covered with lights. The stainless steel appliances are in nice harmony with walnut cabinets. 

You can see a black door, a garbage can (empty), a Refrigerator (in which are Strawberry, Ginger, Banana, Milk and Orange) and a cabinet (in which is cinnamon) here.

>[4] drop blender
Dropped.

>[5] take banana
Taken.

>[6] put banana in blender
You put Banana into Blender.

Nice!

>[7] take strawberry
Taken.

>[8] put strawberry in blender
You put Strawberry into Blender.

Nice!

>[9] take milk
Taken.

>[10] put milk in blender
You put Milk into Blender.

Nice!

>[11] take cinnamon
Taken.

>[12] put cinnamon in blender
You put cinnamon into Blender.

Nice!

>[13] mix
I hope it tastes good

    *** Wonderful! What a velvety, creamy masterpiece. ***

Would you like to RESTART, RESTORE a saved game, QUIT or UNDO the last command?

>restart
It was 9A.M. and Tom was awake. He wasn't feeling like usual. Somehow, he was tired even though he had slept pretty well. His schedule was like before, his fiance as lovely as ever, and his boss as tolerable as ever. He didn't know what was wrong with him... He thinks... and thinks... and thinks... Finally! He remembers... His meals, in the last few weeks, were all processed foods. He decided he had enough… It was time to make some changes in his lifestyle. So, he decided, instead of the usual StarBucks breakfast, he will have a smoothie. He dashed out of his bed and went to kitchen.

He took off his phone and looked up the recipe of his favorite smoothie, "Banana Strawberry Milkshake" with a touch of "Cinnamon".

"Preparation time: 7min

Calories: 370"

Perfect Breakfast
An Interactive Fiction by Amir Ashkan Nourkhalaj
Release 1 / Serial number 150506 / Inform 7 build 6L38 (I6/v6.33 lib 6/12N) SD

Kitchen
The kitchen is quite large. The roof is covered with lights. The stainless steel appliances are in nice harmony with walnut cabinets. 

You can see a black door, a garbage can (empty), a Refrigerator (in which are Strawberry, Ginger, Banana, Milk and Orange) and a cabinet (in which is cinnamon) here.

* * *

>take banana
Taken.

>take ginger
Taken.

>take milk
You're carrying too many things already.

>eat milk
(first taking Milk)
You're carrying too many things already.

>eat banana
You eat Banana. Not bad.

>take milk
Taken.

* * *

>test win
(Testing.)

>[1] s
(first opening the black door)

Garage
The garage is slightly messy. Then again, what garage isn't. There is a ping pong table dissembled on the ground, a bicycle chained to the wall and a new shining shelf, in harsh contrast with its surrounding inside the garage.  

You can see a black door, a bicycle, a heavy ping pong table and a shelf (in which are Blender (empty), a scale and a juicer) here.

>[2] take blender
Taken.

>[3] take bicycle
That's fixed in place.

>[4] take juicer
Taken.

>[5] n

Kitchen
The kitchen is quite large. The roof is covered with lights. The stainless steel appliances are in nice harmony with walnut cabinets. 

You can see a black door, a garbage can (empty), a Refrigerator (in which are Strawberry, Ginger, Banana, Milk and Orange) and a cabinet (in which is cinnamon) here.

>[6] put blender down
Dropped.

>[7] put juicer into blender
You can't do that.

>[8] put juicer inside blender
You can't do that.

>[9] eat blender
That's plainly inedible.

>[10] take banana
Taken.

>[11] put banana in blender
You put Banana into Blender.

Nice!

>[12] take strawberry
Taken.

>[13] put strawberry in blender
You put Strawberry into Blender.

Nice!

>[14] take garbage can
Taken.

>[15] put garbage can in blender
You can't do that.

>[16] drop garbage can
Dropped.

>[17] take ginger
Taken.

>[18] put ginger in blender
You put Ginger into Blender.

Nice!

>[19] x blender
In Blender are Ginger, Strawberry and Banana.

>[20] take ginger
Taken.

>[21] put ginger in fridge
You put Ginger into the Refrigerator.

Nice!

>[22] x blender
In Blender are Strawberry and Banana.

>[23] take milk
Taken.

>[24] put milk in blender
You put Milk into Blender.

Nice!

>[25] take cinnamon
Taken.

>[26] put cinnamon in blender
You put cinnamon into Blender.

Nice!

>[27] mix
I hope it tastes good....

    *** Wonderful! What a velvety, creamy masterpiece. ***

Would you like to RESTART, RESTORE a saved game, QUIT or UNDO the last command?

>x mixer
In mixer are cinnamon, Strawberry and Banana.

* * *

>test lose
(Testing.)

>[1] s

Garage
You can see a black door and a shelf (in which are mixer (empty), a scale and a juicer) here.

>[2] take blender
You can't see any such thing.

>[3] w

Kitchen
You can see a black door, a garbage can, a Refrigerator (in which are Ginger, Milk and Orange) and a cabinet (in which is cinnamon) here.

>[4] drop blender
You can't see any such thing.

>[5] take banana
You already have that.

>[6] put banana in blender
You can't see any such thing.

>[7] take strawberry
You already have that.

>[8] put strawberry in blender
You can't see any such thing.

>[9] take milk
You're carrying too many things already.

>[10] take cinnamon
You're carrying too many things already.

>[11] put cinnamon in blender
You can't see any such thing.

>[12] mix
I hope it tastes wonderful
It tastes disgusting.

* * *

I beg your pardon?

* * *

>undo
Kitchen
[Previous turn undone.]

>test lose
(Testing.)

>[1] s

Garage
You can see a black door and a shelf (in which are a scale and a juicer) here.

>[2] take blender
You can't see any such thing.

>[3] n

Kitchen
You can see a black door, Blender (in which are cinnamon, Milk, Strawberry and Banana), a garbage can (empty), a Refrigerator (in which are Ginger and Orange) and a cabinet (empty) here.

>[4] drop blender
Blender is already here.

>[5] take banana
Taken.

>[6] put banana in blender
You put Banana into Blender.

>[7] take strawberry
Taken.

>[8] put strawberry in blender
You put Strawberry into Blender.

>[9] take milk
Taken.

>[10] take cinnamon
Taken.

>[11] put cinnamon in blender
You put cinnamon into Blender.

>[12] put milk in blender
You put Milk into Blender.

>[13] mix
I hope it tastes wonderful

    *** Wonderful ***

Would you like to RESTART, RESTORE a saved game, QUIT or UNDO the last command?

* * *

>test lose
(Testing.)

>[1] s
(first opening the black door)

Garage
The garage is slightly messy. Then again, what garage isn't. There is a ping pong table dissembled on the ground, a bicycle chained to the wall and a new shining shelf, in harsh contrast with its surrounding inside the garage.  

You can see a black door, a bicycle, a heavy ping pong table and a shelf (in which are Blender (empty), a scale and a juicer) here.

>[2] take blender
Taken.

>[3] n

Kitchen
The kitchen is quite large. The roof is covered with lights. The stainless steel appliances are in nice harmony with walnut cabinets. 

You can see a black door, a garbage can (empty), a Refrigerator (in which are Strawberry, Ginger, Banana, Milk and Orange) and a cabinet (in which is cinnamon) here.

>[4] drop blender
Dropped.

>[5] take banana
Taken.

>[6] put banana in blender
You put Banana into Blender.

Nice!

>[7] take strawberry
Taken.

>[8] put strawberry in blender
You put Strawberry into Blender.

Nice!

>[9] take milk
Taken.

>[10] take cinnamon
Taken.

>[11] put cinnamon in blender
You put cinnamon into Blender.

Nice!

>[12] put milk in blender
You put Milk into Blender.

Nice!

>[13] put orange in blender
(first taking Orange)
You put Orange into Blender.

Nice!

>[14] mix
I hope it tastes good....

    *** Too sour... too acidic for breakfast... It's unfortunate... ***

Would you like to RESTART, RESTORE a saved game, QUIT or UNDO the last command?

>restart
It was 9A.M. and Tom was awake. He wasn't feeling like usual. Somehow, he was tired even though he had slept pretty well. His schedule was like before, his fiance as lovely as ever, and his boss as tolerable as ever. He didn't know what was wrong with him... He thinks... and thinks... and thinks... Finally! He remembers... His meals, in the last few weeks, were all processed foods. He decided he had enough… It was time to make some changes in his lifestyle. So, he decided, instead of the usual StarBucks breakfast, he will have a smoothie. He dashed out of his bed and went to kitchen.

Assignment4
An Interactive Fiction by Amir Ashkan Nourkhalaj
Release 1 / Serial number 150506 / Inform 7 build 6L38 (I6/v6.33 lib 6/12N) SD

Kitchen
You can see a black door, a garbage can (empty), a Refrigerator (in which are Strawberry, Ginger, Banana, Milk and Orange) and a cabinet (in which is cinnamon) here.

>test win
(Testing.)

>[1] s
(first opening the black door)

Garage
You can see a black door and a shelf (in which are Blender (empty), a scale and a juicer) here.

>[2] take blender
Taken.

>[3] n

Kitchen
You can see a black door, a garbage can (empty), a Refrigerator (in which are Strawberry, Ginger, Banana, Milk and Orange) and a cabinet (in which is cinnamon) here.

>[4] drop blender
Dropped.

>[5] take banana
Taken.

>[6] put banana in blender
You put Banana into Blender.

>[7] take strawberry
Taken.

>[8] put strawberry in blender
You put Strawberry into Blender.

>[9] take milk
Taken.

>[10] put milk in blender
You put Milk into Blender.

>[11] take cinnamon
Taken.

>[12] put cinnamon in blender
You put cinnamon into Blender.

>[13] mix
I hope it tastes wonderful

    *** It tastes disgusting. ***

Would you like to RESTART, RESTORE a saved game, QUIT or UNDO the last command?

* * *

>s
(first opening the black door)

Garage
You can see a black door and a shelf (in which are Blender (empty), a scale and a juicer) here.

>take blender
Taken.

* * *

>n
Kitchen
You can see a black door, a garbage can (empty), a Refrigerator (in which are Strawberry, Ginger, Banana, Milk and Orange) and a cabinet (in which is cinnamon) here.

>drop it
The cabinet is already here.

>drop blender
Dropped.

>put ginger in the blender
(first taking Ginger)
You put Ginger into Blender.

>blend
I hope it tastes wonderful

    *** asdfadsf It tastes disgusting. ***

Would you like to RESTART, RESTORE a saved game, QUIT or UNDO the last command?

* * *

>undo
Kitchen
[Previous turn undone.]

>test win
(Testing.)

>[1] s

Garage
You can see a black door and a shelf (in which are a scale and a juicer) here.

>[2] take blender
You can't see any such thing.

>[3] n

Kitchen
You can see a black door, Blender (in which are Orange, Milk, Strawberry and Banana), a garbage can (empty), a Refrigerator (in which is Ginger) and a cabinet (empty) here.

>[4] drop blender
Blender is already here.

>[5] take banana
Taken.

>[6] put banana in blender
You put Banana into Blender.

Nice!

>[7] take strawberry
Taken.

>[8] put strawberry in blender
You put Strawberry into Blender.

Nice!

>[9] take milk
Taken.

>[10] put milk in blender
You put Milk into Blender.

Nice!

>[11] take cinnamon
You already have that.

>[12] put cinnamon in blender
You can't do that.

>[13] mix
I hope it tastes wonderful

    *** Too sour. ***

Would you like to RESTART, RESTORE a saved game, QUIT or UNDO the last command?

* * *

>blend
There is no blender in the kitchen.

>s
(first opening the black door)

Garage
You can see a black door and a shelf (in which are Blender (empty), a scale and a juicer) here.

* * *

>drop blender
Dropped.

>blend
There is nothing in the blender.

>take banana
Taken.

>take cinnamon
Taken.

>put cinnamon and banana in the blender
cinnamon: Done.
Banana: Done.

>x blender
In Blender are Banana and cinnamon.

>take milk and strawberry
Milk: Taken.
Strawberry: Taken.

>put them in the blender
I'm not sure what 'them' refers to.

>put milk and strawberry in the blender
Milk: Done.
Strawberry: Done.

>put orange in the blender
(first taking Orange)
You put Orange into Blender.

>x blender
In Blender are Orange, Strawberry, Milk, Banana and cinnamon.